カレンダア|lịch
まんなか|chính giửa
ごくろうさま|rất cảm ơn
そのままにします|cứ để dấy
そうこ|kho
じゅんびします|chuẩn bị
しりょう|tư liệu, tài liệu
ふきます|lau
まだ|còn, chưa
きちんと|ngay ngắn
のせます|chất lên
まわり|chung quanh
かべ|tường
おろします|đem xuống
テイブリ|bàn ăn
ならべます|sắp xếp
はります|dán
だい|đế
しまいます|hoàn thành
かけます|treo
ドリぐ|mũi khoan
さぎょう|thao tác
ポスタア|bích chương quảng cáo
ハンガア|cái móc áo
こうぐ|dụng cụ
もとのところ|chổ củ
ハンマア|búa
れいぞうこ|tủ lạnh
きれいに|làm sạch sẽ
ひきだし|ngăn kéo
