てぶくろ|găng tay
くつした|tất
ていき|vé tháng
さいふ|ví
ふくろ|túi,bao
ひも|dây
ポケット|túi
ズボン|quần dài
てちょう|sổ tay
かいません|không sao đâu
このくらい|cở như thế này
よかった|tốt quá
ほんとうだ|đúng vậy
いまの|vừa rồi
しょるい|tài liệu
あみだな|giá để đồ trong toa xe
りょうめ|toa tàu thứ
かかります|bị khóa lại
よごれます|bị bẩn
すきます|trống vắng
こみます|bị kẹt
われます|bị vở
こわれます|bị hỏng
やぶれます|bị rách
きれます|bị đứt
おとします|đánh rơi
コップ|cái ly, cái cốc
ちゃわん|cái bát
ガラス|thủy tinh
びん|cái chai
ひろいます|nhặt, lượm
すてます|vứt bỏ
さら|cái đĩa
まちがえます|nhầm, lẫn lộn
