きゅうけいします|nghỉ giải lao
そうだんします|hỏi ý kiến
きめます|quyết định
まとめます|tóm tắc
たてます|xây dựng
でます|ra, tốt nghiệp
しゅっぱつします|xuất phát
しゅっちょうします|đi công tác
よてい|dự định
はる|mùa xuân
なつ|mùa hạ
あき|mùa thu 
ふゆ|mùa đông
くうこう|sân bay
いなか|nhà quê
ちち|bố
はは|mẹ
あに|anh 
あね|chị
しゃちょう|giám đốc
ぶちょう|trưởng ban
かちょう|chủ nhiệm
はじめ|khởi đầu
おわり|kết thúc
こんどの|.. tới
ゆっくり|chậm, thong thả
もうすぐ|sắp, ngay
いっしょうけんめい|chăm chỉ
いいな|hay quá nhỉ
よかったら|nếu được thì
え|ủa
いいんですか|có đươc ko
たのしみにしています|lpongf vui mừng trông ngóng...
