すきます|trống vắng
ガラス|thủy tinh
よかった|tốt quá
しょるい|tài liệu
ふくろ|túi,bao
りょうめ|toa tàu thứ
ほんとうだ|đúng vậy
ズボン|quần dài
びん|cái chai
ちゃわん|cái bát
さら|cái đĩa
あみだな|giá để đồ trong toa xe
こわれます|bị hỏng
てちょう|sổ tay
よごれます|bị bẩn
いまの|vừa rồi
きれます|bị đứt
やぶれます|bị rách
ポケット|túi
ていき|vé tháng
コップ|cái ly, cái cốc
ひも|dây
われます|bị vở
くつした|tất
てぶくろ|găng tay
さいふ|ví
かかります|bị khóa lại
まちがえます|nhầm, lẫn lộn
このくらい|cở như thế này
ひろいます|nhặt, lượm
すてます|vứt bỏ
こみます|bị kẹt
かいません|không sao đâu
おとします|đánh rơi
